NO ./textures/door_2.xpm
EA ./textures/EA_256.xpm
WE ./textures/WE_256.xpm
SO ./textures/SO_256.xpm

F 220,100,400
C 225,30,0


1111111111111111111111
1E00000000000000000001
11001d0000011111111111
100111100001
100000100001
100d00d00001
1001d1100001
100000000001
100000001001
1000x0010001
100000100001
111111111111
