111111111111
1Eddddddddd1
11dd1dddddd1
111111111111
