NO ./textures/door_2.xpm
EA./textures/EA_256.xpm
WE ./textures/WE_256.xpm     
SO ./textures/SO_256.xpm

                F 0,100,1
      C 105,30,200      
        1111111111111111111111111
        1000000000110000010001001
        1011000001110001010100001
        1001000000000001000101001
111111111011000001110000010000001
100000000011000001110111111111111
11110111111111010100000010001
11110111111111010101010000001
11000000110101010100000010001
1000000000E000010000000010001
100100000000000011010100100001
1100000111010101111101111000111111111
11100111 1110101 10111101000000000001
11111111 1111111 11111111111111111111
